########################
########################
####   # ^ #       #####
#### # # #*##### # #####
#### # # # #     # #####
###### # # # ##### #####
######   #   #     #####
###### ### ##### #######
##   # #   # #   # #   #
#### # # ### # ### # ###
##     #     #   #   ^ #
## # # # # # ####### ###
## # # # # # # #       #
#### ######### ##### ###
#### # #####   #     # #
#### # ####### # #*# # #
##     #####     # #   #
## # #######^##### #####
## #*  #   #   # # #####
###### # ### # # # #####
##           #   #   ###
## ########### # #######
##   ### ###   #     ###
#### ### ### ### ### ###
#### ### #   # # #     #
######## # ### ### #####
#### # # # #           #
#### # # ######### # # #
## #   #   ####### # # #
## ### # ############# #
##         # # ###   # #
#### # # # # # ##### # #
##   # # #     ###    ^#
######## # # ##### #####
######   # #     # ### #
############## # # ### #
##########     #   #   #
################## ### #
##########     #     # #
############ ##### ### #
##########    *# #     #
############## # # # ###
##############     # ###
########################
########################
