##############
#*   #  *#*# #
# # ## ### # #
# ###    #   #
# #^## # ## ##
#      #  ^  #
##############