#############
#*#  #  *#* #
# # ## ### ##
# ###    #  #
#  ^## # ## #
#    # #  ^ #
#############