########################
########################
######               ###
########## ### # #######
##     #     # #     # #
## ####### # ##### # # #
##   ##### # # #   #   #
## # ##### # # ####### #
## # ##### # #         #
#### ####### ### ### ###
####   #     #     #   #
###### # ##### # ### ###
######   ### # # # ^   #
############ ### # #####
######     #   # # # * #
########## # ### ##### #
########             # #
######## ### ######### #
########   # # #   # # #
########*# ### ### # # #
######   # #           #
###### ### ####### # ###
######   #   # #   #   #
###### # ### # # ### ###
###### # #   # #   #   #
###### ##### # ### #####
######   #   #       #*#
########## ####### ### #
####   ### #           #
###### ### # ####### ###
######     # # # # #   #
########## # # #*# #####
######       ^ #       #
###### ### ####### ### #
###### #             # #
###### ##### # ### ### #
#### # #     # # # # # #
#### # # # ##### ### # #
####   # # #    ^###   #
######## ### ###########
########   #     #######
########## # # # #######
##########  ^# # #######
########################
########################
