########
#*    *#
#      #
#      #
#      #
#      #
#      #
#      #
#      #
#      #
#      #
#      #
#      #
#*    *#
########