###############
###############
#     * #     #
##### ### #####
###           #
##### ##### ###
# *   #       #
##### ### # ###
#*### # # # # #
# ##### # ### #
#       #   #^#
# ### # # # # #
# # # # * #   #
### ##### ###^#
#       #   # #
# ###########^#
# #   # #   # #
# # # # ### # #
#   #   ^     #
##### ####### #
#       #   # #
# ### ##### ###
#   # #   #   #
### # ### # # #
#   # # #   # #
##### # # # # #
#####     # # #
###############
###############
