########
#*  # *#
# ### ##
# #    #
# # ####
#   #  #
# # ## #
#   ^# #
# ######
#  #^  #
## #   #
#    ###
# ##   #
#*#  #*#
########