########################
########################
#     #     ############
# # ### # ##############
# # #   # #   ##########
### # ### # # ##########
#   # # #   # ##########
### # # ### ############
#   # # # # ############
# ### # # # ############
# ^ # #     ############
# ######### ############
#     #       ##########
### ### ### ############
# #^#   # # # ##########
# # # ### # # ##########
# #   #     #   # ######
# # # # # # # ### ######
#   # # # #   # #     ##
### ###########*# # ####
#     #   #   #   #   ##
### ##### # ### ### ####
#   #   # #   # #   # ##
# ##### # # ### ##### ##
#     #     # # #     ##
# # # ### ###^#*# ### ##
# # #               # ##
# # # # # ####### ######
# # # # #   # #   #   ##
### ######### ### # # ##
### #   *       #   # ##
####### # ##### # ### ##
#    ^  # #*# #   # # ##
# ##### ### # ### # ####
# ##### #       # #   ##
# ##### ### # ### # # ##
# # ### # # #   # # # ##
# # ### # ### # # # ####
#   ### #     #       ##
############# # ### ####
###########   #   # ####
############### ########
#########       ########
########################
########################
