########
#   #  #
# ### ##
# #    #
# # ####
#      #
# # ## #
#   ^# #
# #### #
#  #^  #
## #   #
#    ###
# ##   #
# #  # #
########