########
#      #
# *  * #
#      #
#      #
#      #
#      #
#      #
#      #
#      #
#      #
#      #
# *  * #
#      #
########