# # # # # # # # # # # # # # #
# # # # # # # # # # # # # # #
#       #       #       #   #
#   # # #   # # # # #   #   #
#               #       #   #
#   #   # # #   #   #   #   #
#   #   #       #   #   #   #
# # #   #   # # #   #   #   #
#       #           #       #
#   #   # # # # # # #   #   #
#   #   #               #   #
#   # # #   #   # # #   # # #
#   #   #   #   #   #   #   #
#   #   # # # # #   #   #   #
#       #   #       #   #   #
#   # # #   # # #   # # #   #
#   #   #                   #
#   #   # # #   # # # # #   #
#   #                   #   #
#   # # #   #   # # # # # # #
#           #               #
# # # # #   #   # # # # #   #
#       #   #   #           #
#   # # #   # # # # # # # # #
#       #           # # # # #
#   # # #   #   # # # # # # #
#           #       # # # # #
# # # # # # # # # # # # # # #
# # # # # # # # # # # # # # #
