##########
# #*  #  #
# # # ## #
# # #### #
#     #  #
# # # # ##
# ### # ##
#  #  #  #
#^^^^ # ##
# ## ## ##
#        #
##########