##########
#  *     #
# ###### #
# # # ## #
#        #
# # # ####
# # # ####
#        #
#^^^^ ####
##########
#        #
##########