####################
# #*               #
# # # ##     *     #
# # ##      ##  #  #
#   * #         #  #
# # # # #   ##     #
# ### # #          #
#  #  #     ##  #  #
#^^^^ # #       #  #
# ## ## #   ##     #
#                  #
####################